[TITLE]
World #1-ranked Tennis Players

[DESCRIPTION]
We're looking for names of ATP World number 1 ranked men's singles players, since 2nd June 1974.

[LIST]
Ilie Nastase === Nastase
John Newcombe === Newcombe
Jimmy Connors === Connors
Bjorn Borg === Borg
John McEnroe === McEnroe
Ivan Lendl === Lendl
Mats Wilander === Wilander
Stefan Edberg === Edberg
Boris Becker === Becker
Jim Courier === Courier
Pete Sampras === Sampras
Andre Agassi === Agassi
Thomas Muster === Muster
Marcelo Rios === Rios
Carlos Moya === Moya
Yevgeny Kafelnikov === Kafelnikov
Patrick Rafter === Pat Rafter === Rafter
Marat Safin === Safin
Gustavo Kuerten === Kuerten
Lleyton Hewitt === Hewitt
Juan Carlos Ferrero === Ferrero
Andy Roddick === Roddick
Roger Federer === Federer
Rafael Nadal === Rafa Nadal === Nadal
Novak Djokovic === Djokovic
Andy Murray === Murray